  ####
###  ####
#  $    #
# #  #$ #
# . .#@ #
#########
